 UAT测试及系统正式上线的技术支持工作。    	__label__0
BUG分析,定期分析用户频繁出现的bug,对有争议的bug做分析报告    	__label__0
对人力数据进行监控，不断发现人力风险进行预警并及时提供相应信息进行处理。    	__label__1
解决语言障碍的同时，还需要搭建一个沟通平台。    	__label__0
然而，新经济的到来注定要改变人们旧有的一切，作为电子商务技术在人力资源管理领域的应用，一个试图要取代HRMS而成为人力资源领域内最热门的词汇之一的“eHR”有人写成“eHR”得以诞生。    	__label__1
目前，对人力资源管理软件称呼较多的就是“HRMS”，世界三大管理软件供应商都称自己的人力资源管理类软件为“HRMS”    	__label__1
尚未国际化之前，英语能力并不是国企员工的必要素质之一。    	__label__0
需求测试：所有需求的性能、逻辑测试应用、测试评估，上线及用户培训；    	__label__0
工作业绩：成功完成10个项目，包括大洋集团HRIS一期、喜高实业HRIS、摩比天线HRIS、深圳机场HRIS绩效考核等。     	__label__1
这一代的产品不仅仅能在管理人员操作下完成工作，还能告诉管理人员在特定条件下如何做。    	__label__0
对各系统中不太符合人力资源习惯的字段名称进行标注和改进。     	__label__1
人力资源管理本来就没有定式，也没有固定的流程，想要在软件中实现这些五花八门的管理流程，要么是巨量的配置和极其复杂的配置，要么就是固定、死板和大量的二次开发。    	__label__1
在eHR系统项目上，提出引入项目监理的环节，为eHR系统的成功上线提供了强有力的保障。监理商介入后，进行了需求对接、辅助选型、开发过程监理的工作，有效降低了公司同监理商、软件供应商三方间的沟通成本，提高了系统开发的效率和质量。     	__label__1
国网北京电力公司三集五大建设（组织机构重组和子公司上线）    	__label__0
二线计提方案设计及推动落地，各相关配合部门或系统工作协调     	__label__1
兼职产品经理    	__label__0
不同品牌、不同职能的人员考勤、薪酬制度上均有所差异，给考勤薪资的方案设计加大了难度。    	__label__1
作为项目经理，负责国家电网公司北京市电力公司ERP系统实施和运行维护     	__label__1
项目3 中核汇能视频会议项目 35+98=133万    	__label__0
管理员后台管理功能    	__label__1
服务器和数据库的日常维护。    	__label__0
部分关键项目：    	__label__0
 结合业务场景和用户需要，构建海航集团一期实现的劳动力管理，绩效及培训模块的分析内容及展现思路；    	__label__1
部门方案顾问    	__label__0
内部顾问：主导实施商进场前的业务需求调研和整理，组织人事模块蓝图设计和开发测试，组织人事数据收集培训及数据校验工作；组织人事模块上线运维支持；员工入职信息管理系统二期优化及与PS集成的功能设计及测试工作    	__label__0
协调与相关单位及部门的工作    	__label__0
组建并管理项目团队，在实施过程中高效运作。     	__label__0
目前大牌的eHR厂商不下30家，知名的不下百家。    	__label__1
完成项目流程梳理工作；    	__label__1
制定Peoplesoft项目的管理规范，并确保此规范在项目中的有效应用，以实现项目目标。    	__label__1
服务好员工的HR相关咨询问题；    	__label__1
负责Peoplesoft、BrassRing、SuccessFactors、考勤等已有系统运维。    	__label__1
配置：设计公众号的3个一级菜单和多个子菜单的布局，从人事招聘并兼顾企业文化及品牌宣传的角度，提供企业招聘微信公众号的初始化设计思路；    	__label__0
整理初步eHR系统需求和既有旧eHR系统的问题，为后续的供应商选型工作做准备；    	__label__1
工作业绩：成功完成3个项目，包括台湾呈威集团eHR项目等。    	__label__1
从启动会（项目简介、DEMO演示）开始介入项目，经历需求分析与确认（讲解需求手册并引导客户填写）、项目时间表的安排（与客户项目经理讨论并确认项目时间表，重点设置项目中的里程碑）、系统配置（根据客户需求配置系统）、测试（编写测试案例测试，确保配置的准确性）、培训（对HR最终用户进行操作培训）、操作手册（编写操作手册以供客户参考）、并行（与客户HR一起进行系统中真实数据的试运行），最终完成系统的验收和上线。    	__label__1
eHR相关舆情维护：与eHR系统各供应商及各上下游伙伴保持定期沟通，参加各类线上线下的同业交流活动，了解行业及产品动态，密切关注人力资源信息化的最新技术与趋势，为公司未来开展信息化相关工作提前进行知识储备，同时也维护公司与各伙伴、同行企业间的市场活跃度，为今后可能的进一步交流合作奠定基础。    	__label__1
约谈供应商，了解目前行业通用解决方案；    	__label__0
设计测试用例,根据用户的需求文档书写测试用例    	__label__0
过度竞争、行业不成熟（客户、人力资源管理和eHR开发商都不成熟），让美妙的行业顿时变成荒漠，能够生存就已经非常不错，而一些企业至今仍然惨淡经营，几乎没有实质性的业务，而另外一些已经关门大吉。    	__label__1
负责外包人员管理方案执行，项目全国落地推进，制定个性化场景解决方案；    	__label__0
业务支持，薪资结算和财务凭证对接；    	__label__1
总负责人整个办公系统需求自提整理（人力资源六大板块包含流程、培训考试、人才库、汇总等；协作模块；公司邮箱、通讯录；个人薪资等信息自助查询；通知公告等）跟进开发、测试验收、后期维护。     	__label__1
eHR的曙光绝对不是在第二代产品，而是在下一代。    	__label__1
梳理及确定培训业务体系，提高客户方培训业务规范性；     	__label__0
沟通。    	__label__0
负责SAP系统的人员基础数据需求管理工作；    	__label__0
负责系统功能开发工作，包括页面、报表（XML Publisher、Query）、接口；    	__label__0
接手离职同事担任组织人事模块的实施工作     	__label__1
目前市面上常见的产品多属于此。    	__label__0
这一代产品和第二代的区别在于能够利用这些数据，支持管理决策。    	__label__0
供应商及时进场：积极组织并参与项目招标过程，完成供应商的评估及筛选工作，顺利进入项目实施阶段；     	__label__0
实施范围：全模块     	__label__0
参与PMO，持续优化项目管理和开发流程，提高项目开发效率和质量    	__label__0
 理解并整理美的集团HRBI一期项目内部劳动力市场及人力资本分析模块的业务逻辑和数据分析思路；    	__label__1
担任运维项目项目经理，参与项目管理，同时担任薪酬模块实施主要负责人，负责薪酬模块的实施工作；     	__label__1
负责入职平台的功能测试、UAT准备、操作手册编写、上线培训及支持工作    	__label__1
提供集团员工目标设定、目标重置、年中和年底考核的指标填写、考核结果评估以及能力考核的操作平台，并将考核结果直接与薪资系统关联，实现绩效考核与定级定薪的无缝对接。    	__label__1
越来越多的中国企业在国内获得成功后，开始寻求更广阔的发展空间。    	__label__0
263云通信是263为企业客户提供全方位、一站式的企业通信和协同办公方面的服务    	__label__0
其他工作支持；    	__label__0
 根据功能规划和交互设计，完成视觉风格定义，进行产品视觉设计美化，如：网站风格设计参与产品规划与功能策略制定，从专业角度提供可行的视觉解决方案 协助开发人员进行产品的详细设计以及用户体验的改善设计    	__label__0
 参与大客户的售前解决方案制作，对客户现场需求调研、问题诊断、方案编写与讲解；提升对客户的整体服务方案价值；    	__label__0
向董事会推荐Peoplesoft系统，并最终通过立项审批；    	__label__0
主要职责:    	__label__0
负责微信培训企业号的申请、认证工作；    	__label__0
协助SAP及Eway顾问进行需求调研、解决方案设计和制定，完成HR系统的搭建工作，收集业务部门的关键参数和主数据（员工信息、考勤班次信息、假别信息、考勤项目、薪酬项目）进入测试系统，进行业务测试,对人事入职、转正、异动、离职等，考勤请假、出差、加班、补卡等，薪酬调薪等业务进行重点流程梳理，特别在员工信息和考勤及薪酬的字段整理方面进行了大量的工作，建立了集团的统一标准    	__label__1
 负责胜科南非、英国、中国、欧曼HR模块支持    	__label__1
使用白金人力资源管理软件，实现客户对员工管理、薪酬福利、考勤管理、培训管理等在人力资源管理方面的需求。打破传统的人力资源管理模式，将多个模块整合至一套平台中，提升HR的工作效率和降低企业的管理成本。    	__label__1
基于业务和监管需要，对品骏物流子公司&互联网金融部门人事/薪酬业务进行系统拆分；其中品骏拆分通过物理分离方式实现，互联网金融通过多BU的方式实现。     	__label__1
 针对业务需求提供基于ERP系统的人力资源模块解决方案，并完成系统的配置和实施工作；    	__label__1
就算不是这种软件，现在正牌大厂的产品，依然非常简单。    	__label__1
项目经验（主要）：2015年10月至2016年6月，负责Alpha1 Pro项目    	__label__0
 UAT测试及未来系统上线支持；    	__label__0
这一代产品是下一代产品的重要基础。    	__label__0
 用户操作手册的撰写和最终用户的培训工作；    	__label__0
项目后期工作现场执行经理；    	__label__0
 UAT测试及系统上线支持；    	__label__0
在总部以及出差到全国个地区进行新考勤系统使用的全网培训；    	__label__1
实现人力资源管理的B2B。    	__label__1
eHR产品：犹如小儿科的玩具    	__label__1
新功能测试,产品会定期更新升级做一些新功能,对这些新功能做 full test.    	__label__0
项目组首先从业务层面给海澜进行梳理，对一些不合理的业务给出专业建议，针对以前一些错误或者繁琐的流程，也进行了相对应的优化。最终实现海澜人事业务的集团化、统一化、标准化    	__label__1
这个时代的特征是产品以信息录入、共享和输入为主，这一代的产品很少能够实现在线管理功能的，如人力资源规划、绩效评价，其方式是在线下做完这些工作，再将这些信息录入系统共享和输入。    	__label__1
人力资源管理：结合企业变革，负责下属3个部门的组织规划、人员招聘、培训开发、绩效考核等工作，推行企业各项人力资源制度，组织各项企业文化推广活动。    	__label__1
结合公司实际和个人产品化专长，使用EHR、OA办公系统时提出流程及操作优化需求、完善后自测；向相关部门提供合理、专业的数据输出报告等；    	__label__1
使用JavaScript、jQuery实现交互动画效果，实现网页的动态效果以及验证等    	__label__0
完成新疆省电力公司和田电力公司本部和下属县级单位的ERPHR模块上线。负责国家电网公司新疆省电力公司ERP系统建设推广项目，HR模块建设推广工作。包括需求分析、功能说明书编写、系统配置、系统测试、用户培训、权限配置、数据收集等相关工作。负责新疆省电力公司和田地州电力公司和下属县级单位的推广工作，包括需求分析、系统培训、系统测试、用户培训、权限配置、数据收集、系统上线等相关工作     	__label__1
2016年华源惠众垃圾发电公司ERP项目 990万    	__label__0
担任功能顾问，负责组织人事模块运维工作     	__label__1
CardinalHealth 为全球50强企业康德乐中国实施HRM人力资源管理软件系统和ESS员工自助服务软件系统。解决集团内近2000名员工的薪资计算问题，为HR提升效率30%以上。同时开通白金软件与Workday软件的数据接口，使员工的基础信息直接从接口调入，无需进行人工二次维护。而ESS的使用，使员工可以自主通过网络查询个人的工资单和公司公告，减少HR的工作负担。在试运行和并行过程中，为客户HR进行系统操作培训，并撰写测试用例和操作手册，保障客户按照计划完成项目。     	__label__1
整合各分公司的HR系统，实现数据及时同步共享。    	__label__1
根据广汽三菱长沙工厂对员工的考勤及排班业务需求，实施Kronos劳动力管理软件的考勤及排班模块；     	__label__1
作为HR模块组长，负责ERPHR模块运维过程中的疑难问题解决，负责HR模块小组管理工作。    	__label__1
作为程序员，从事算法的研发和程序代码的编写。期间负责过上海贝尔阿尔卡特将其通讯软件所用数据存储从原有的Oracle向Sybase迁移的外包项目。    	__label__0
考勤项目全网成功实施    	__label__1
主要产品经理&知识管理员:负责个别产品的孵化和所有产品的标准化、上线、更新等    	__label__0
负责系统具体实施工作，兼作项目经理管控项目进度     	__label__0
“eHR” 不仅使企业的人力资源管理自动化，实现了与财务流、物流、供应链、客户关系管理等系统的关联和一体化，而且整合了企业内外人力资源信息和资源与企业的人力资本经营相匹配，使HR从业者真正成为企业的战略性经营伙伴。    	__label__1
做好项目的时间管理、变更管理、风险管理    	__label__0
负责华东区主要的售前支持工作；    	__label__0
负责HR系统日常运维，权限管理，功能优化等。     	__label__0
工作描述：据产品设计师的策划文档和原型设计，充分理解产品经理的产品设计，在UI设计中体现产品的视觉整体性、交互性，注重细节的处理    	__label__0
对整体实施流程、项目需求、初步报价区间、实施周期等各关键因素进行评估，形成可行性分析报告；    	__label__0
微商通 产品经理 仕德伟科技自建的第三方微信建站平台,提供微站、微商城、微服务等基于微信公众平台的模块化和定制化的建站服务,平台积累企业级客户300家左右    	__label__0
 制定市场推广策略    	__label__0
 考勤模块、绩效模块业务调研及方案设计，后续具体实施工作由其他同事接手     	__label__1
这些平台的集成以门户的形式表现出来，再加上外部服务商构成的电子商务网络，比如在线招聘、在线薪资、在线学习等，一种适应以网络化、知识化、全球化为特征的人力资源管理模式就是eHR。    	__label__1
 参与丰益集团SAP HR模块的实施。    	__label__1
功能测试,针对特定客户对产品进行regression/smoke/customization测试    	__label__0
调研单位:成都精英达人力资源有限公司    	__label__1
负责需求沟通和方案设计，完成功能开发、测试、上线；    	__label__0
参与系统实施，负责 PeopleSoft 系统开发和运维管理工作。    	__label__1
作为甲方负责人，确保系统的有效迁移，涉及历史数据的完整迁移或备份，迁移前后功能完备性和一致性。     	__label__0
协助推动人力资源信息化项目的实施落地    	__label__1
其他人力资源事务性工作：招聘、员工二级档案、入离职手续处理、薪酬福利事项处理等。    	__label__1
它利用各种IT手段和技术，比如互联网、呼叫中心、考勤机、多媒体、各种终端设备等    	__label__0
造成新人入职时体验差,培训效果一般,评估困难    	__label__1
负责永辉超市SAPHR完善提升，与其他系统和项目集成工作，负责新系统选型和实施工作。     	__label__1
在平台的规划过程中，带领所属团队，深入了解业务部门的需求“痛点”，引导他们准确的表达出业务需求的核心点，梳理出核心业务流程并加以优化。在充分调研的基础上，制定出覆盖相关各方多数需求（或诉求点）的HRIS方案，并最终获得审议通过。    	__label__1
作为项目经理全面管理公司Peoplesoft项目，确保Peoplesoft系统成功替换原有奇正系统。    	__label__1
eHR貌似美妙的前景，让很多软件厂商和管理咨询公司纷纷开发eHR软件。    	__label__1
四个月内,成功组建一支25人精英团队负责路由器的开发工作    	__label__1
新项目实施：    	__label__0
完成福建省电力公司南平市电力公司本部和下属县级单位的ERPHR模块上线，负责国家电网公司福建省电力公司ERP系统建设推广项目，HR模块建设推广工作。包括需求分析、功能说明书编写、系统配置、系统测试、用户培训、权限配置、数据收集等相关工作。负责福建省电力公司南平市电力公司本部和下属县级单位的推广工作，包括需求分析、系统培训、系统测试、用户培训、权限配置、数据收集、系统上线等相关工作。     	__label__1
与后端人员合作将数据渲染到页面    	__label__0
根据公司发展战略制定公司技术规划    	__label__0
第三代eHR产品是决策支持时代。    	__label__1
负责eHR系统项目各种立项文档、工作签报的编写     	__label__1
权限拆分和管理，历史遗留问题数据的清理；    	__label__0
综合来讲，eHR是一种全新的人力资源管理模式，它代表了人力资源管理的未来发展方向。    	__label__1
为客户中集团中多家公司放入同一HRM系统提供解决方案和建议，并对此排定实施方案和项目时间表。对集团此前相对独立的体系和政策进行梳理和归纳，根据每家公司的特点，最终将集团旗下多家公司整合至一套HRM系统中。     	__label__1
为客户（多数为外资企业）提供系统实施服务和人力资源解决方案    	__label__1
工作业绩：    	__label__0
 现状业务需求调研及分析    	__label__0
通过系统的上线，加快了总分公司间数据共享的实时性；    	__label__0
按公司负责人管理范围实现数据控制    	__label__1
实现赫基国际的员工时间管理需求，包含员工的时间与出勤管理、加班管理、休假管理等方面的内容；    	__label__1
主要负责组织人事、时间管理工作流系统以及部分个性化模块的实施工作。    	__label__1
培训分公司人事，指导其准备基础数据表格和系统操作工作；    	__label__1
统筹梳理公司各地区社保政策、个性化业务；    	__label__1
三、运营过程无失误    	__label__0
实际上，eHR市场的生生死死起起伏伏让这个行业满了混乱和悲伤。    	__label__1
充分了解产品需求，并对用户提交的需求仔细分析评估，对于合理需求要不断完善补充到需求分析说明书中    	__label__0
组建CDN团队 鉴于互联网CDN市场的前景,在零基础的情况下,配合技术副总裁组建CDN分公司    	__label__0
顺丰一二三线薪酬智能化，在快递业务多种个性化成场景下，灵活快捷计算计提，含线上化及透明化     	__label__1
为了生存，企业开始不负责任的对客户海吹牛皮，一些企业疯狂签单却不用心开发产品和负责人的实施，还有很多走冷门的eHR厂商，比如专门做elearning、etraining、“下一代”SaaS超前产品的，还没有摸到客观的实质客户和收入。    	__label__1
确认业务逻辑并形成产品需求文档；    	__label__0
世界知名的市场研究公司Gartner也称这类软件为“HRMS”。    	__label__1
项目开展的三个月内完成招聘三十四人,设计到大数据库开发、    	__label__1
在满足新苏集团整所有基本业务的前提下，系统提供了10余张报表，按公司、人员类别、人员属性等进行多纬度的全面分析。    	__label__1
支持产品上线，持续跟踪使用效果并优化相关功能     	__label__0
完成全国销售人员绩效薪酬信息化；     	__label__1
eHR时代到来    	__label__1
完成浙江、广西、印尼分公司HRIS上线，在印尼分公司HRIS上线过程中，将系统变更为印尼文版本，以便当地HR人员使用。    	__label__1
作为爱屋吉屋的eHR负责人，全面掌控爱屋吉屋HRIS体系的构建。    	__label__1
负责平台组件模块设计及上线后的推广支持    	__label__0
需求梳理：对规范性/合理性较低的需求提出优化建议，并同步调整需求开发时间，完成项目排期的及时跟进；     	__label__0
工作描述：参与事业部的筹建，负责多项目的组织、管理，以及技术运维团队的日常运作    	__label__0
业务分析    	__label__0
新人在日常工作中有提出培训需求    	__label__1
以上是我公司为对候选人费俊文的调研分析报告,文件中有需要保密的内容,请传阅时严格控制在与此次招聘有关的负责人手中    	__label__1
 根据用户需求增强程序功能    	__label__0
 海鸥II项目累计投入1亿,项目工期预计5年,参与人员累计超过500人    	__label__0
水晶报告和提醒功能的上线，大大提升了HR的工作效率，使最终用户无需再为记忆各种不同的到期日和编辑各式繁琐文档而发愁。上线后，系统会自动提醒HR相关的到期日及需要做的后续操作，文档只需通过系统简单操作，就可以批量准确地打印出来。     	__label__1
主要负责ehr系统各模块系统设计及项目管理工作    	__label__1
 系统流程的优化     	__label__0
员工关怀与企业文化宣传；    	__label__1
担任该项目的产品经理,基于公司BPM流程引擎,设计、开发两票业务管理平台,并实现与无源智能锁物联网硬件的集成, 专家远程支持云平台项目 该产品基于母公司红云融通领先的音视频互动技术,开发面向电力行业的专家远程支持平台,平台为企业提供多方视频互动、专家资源管理、设备管理、3D仿真、即时通讯、评价管理等诸多功能    	__label__0
确定项目需求    	__label__0
 多渠道考勤数据统一收集；    	__label__1
人力资源将各类表格、标准化试题等编制成特定程序放在招聘网页上，应聘者在线提交简历并完成测验，简历与测验成绩都保存在数据库中。    	__label__1
负责基础数据表格的制作、数据初始化批量导入；    	__label__0
对人力资源管理者来说，多元化带来的沟通和融合难题，跨地域给人事管理带来的重重障碍等问题，正向他们迎面而来。    	__label__1
 实施方案设计    	__label__0
 担任项目经理，负责项目管理工作    	__label__0
HRIS成功上线（含广东深圳、江西吉安、陕西西安3个区域）。     	__label__1
按合同期限收回自己客户的应收猎头佣金    	__label__1
综合计划与预算溯源和接入项目（2015年1月至2015年7月）    	__label__0
设计“微课程”模板，制作操作手册，并指导培训同事熟悉课程的制作方法与日常维护操作。     	__label__0
人力资源相关表单优化：整理比较用友NC系统、致远OA系统和既有人力资源表单（如应聘登记表、入职登记表等）同一内容的不同名称，对不同处进行统一，保证各表单内容的一致性；    	__label__1
从国际上来看，在20世纪70年代末到80年代初，基于DOS的单机版软件开始用于人事管理和人力资源管理    	__label__1
实现涵盖HR业务人员，部门负责人，晋升评审委员会等多类型用户的全线上流程体验；通过移动端和PC端协同打造从提名，评审审批至结果发布并录入系统的全线上化处理。     	__label__1
在技术的协助下，人力资源部门至少能从两个环节入手，减轻企业国际化的“疼痛”。    	__label__1
系统优化：根据用户体验，结合人力资源不同时期的管理需求，不断优化并完善人力资源信息系统功能，包括各类数据分析报告设计等。    	__label__1
交行卡中心全国地区集体上线，且稳定使用；    	__label__1
负责项目的需求分析,制定测试计划,安排测试任务、测试进程,评定测试用例、bug报告,根据实际情况进行测试流程控制    	__label__0
同时鉴于Fusion系统的Payroll模块在国内的“水土不服”，主动发挥互联网金融企业的IT技术优势，协调相关技术部门加入到项目团队中，组织payroll模块的自研开发，使之能够符合公司业务的特点。     	__label__1
进入20世纪90年代，随着网络技术的发展，C/S和B/S架构的网络化的人力资源管理系统相继诞生并得到了充分的应用。    	__label__1
对人力资源项目进行数据分析及监测，对重点人力资源指标（如人均创利等）进行持续性跟踪并提供数据支持。    	__label__1
作为泛微OA系统管理员进行全部需求修改、权限分配调整、表单流程修改与维护。    	__label__1
建立内部平台，员工可通过Blog、Webcast、Podcast等形式，与其他地区的员工或是来自不同文化的同事，更直观地交流工作、分享生活感受，从而让团队之间联系更紧密。    	__label__1
完成独立模块开发    	__label__0
把控项目进度    	__label__0
具有多年应用软件设计及制作经验，4年的团队管理经验    	__label__0
得到了包括中广核新能源、三峡集团、联合动力、南方电网等多个大型企业用户的应用    	__label__0
管理项目计划、成本、质量、风险和产品售后等工作    	__label__0
产品设计：对产品核心功能/开发设计进行评估，并提供可行性建议；    	__label__0
供应商管理：管理外包顾问，对其实施工作进行分配以及评估；     	__label__0
项目管理：协调内部相关人员及外部供应商进行系统需求调研与分析，主导系统规划设计，制定项目计划，把控项目成本、质量、进度及风险，确保项目按期保质完成。    	__label__1
项目业绩: 一、业务评价高,培训提高业务工作效率    	__label__0
提供软硬结合的检修管控云平台 该系统目标是帮助某央企对下属160余家单位10万人的人力资源数据(人事、人才、薪酬、干部、干部监督)进行数据分析和挖掘,帮助企业提升人力资源管控能力,同时为公司人力资源优化提供数据支撑    	__label__1
流程规划/梳理，流程执行与评估，流程优化；发现问题，从根源上解决问题；    	__label__0
解决系统问题，优化系统功能；    	__label__0
Action:全国(5个office)新人入职统一,培训系列课程统一    	__label__1
如果在日常的公函往来中，由于地域不同，A使用英语，B使用德语，C使用中文，D使用越南语，这势必会造成信息模糊和管理混乱。    	__label__0
新eHR系统平台选型：论证建设新eHR系统平台的可行性；    	__label__1
限时抢购频道主产品经理,负责频道整体迭代策划及数据驱动迭代的执行    	__label__0
 承接新加坡胜科SAP HR运维支持    	__label__1
方案制定    	__label__0
数据分析：    	__label__0
解决集团内近2000名员工的薪资计算问题，为HR提升效率30%以上。     	__label__1
员工人数及入离职分析    	__label__1
请贵公司根据人才情况和公司实际情况给予其相应待遇    	__label__1
带领团队开发和实施项目，根据公司规范对项目进行管理，建立和管理项目文档，参与项目售前工作，与客户交流，提供顾问服务，充分理解客户需求，编写项目方案    	__label__0
时间管理、薪酬管理实施顾问，现场项目执行经理     	__label__1
人力资源“三支柱”模式：与咨询公司进行交流，了解业内主流功人力资源共享中心建设模式，学习其成功客户案例的方案。同时收集相关材料，为公司未来做“三支柱”业务模式的咨询做好前期准备工作；    	__label__1
项目验收上线后，由于实施期间双方良好的合作关系，客户决定在2013年新增预算购买本公司的工作流和其他模块的产品，并希望本人继续提供支持。    	__label__1
沪宁线上海段3个站的现场实施，担任实施负责人，得到站长的书面表扬信    	__label__0
担任产品总监,统筹安排产品需求分析、原型设计、资源调配、进度跟踪、成本控制等工作    	__label__0
资生堂；李锦记；福特汽车；美国礼来；菲亚特；德尔福；延锋伟世通；延锋百利得；弗列加；江森鹤华；Hermes；佳丽宝；兄弟中国；中化国际；大昌洋行；创新科技；固安捷；麒麟；高力物业国际等；    	__label__0
这个时代的产品，和上一代最大的产别在于可以在线上完成部分管理工作，如在线进行绩效评价。    	__label__0
确认业务处理，UI设计和产品需求文档撰写；    	__label__0
跨部门资源协调    	__label__0
管控公司保密、军工、电子政务、企业信息化领域的软件架构、平台技术及发展方向    	__label__0
项目描述：263云归档是指对企业邮箱和即时消息数据，进行在线归档、分类管理、长期保留并允许实时搜索和访问    	__label__0
主要负责“人力资源系统”和“会员关系系统”的信息规划、流程优化、业务调研、系统设计、开发测试、实施推广等项目管理工作    	__label__1
 负责医疗类服务产品的设计、研发、运营推广工作    	__label__0
按照“eHR”的上述定义，作为一种新型的人力资源管理模式，HRIS、HRMS只是“eHR”实现和得以运行的软件平台之一，elearning、erecruiting、呼叫中心等同样是“eHR”运行的软件和信息平台。    	__label__1
高管重要事项报备功能    	__label__1
负责SAPHR模块担任国家电网公司北京市电力公司ERP系统HR模块系统运维总体负责人，负责疑难问题解决，负责HR模块小组管理工作，主要承担系统的建设工作。     	__label__1
担任薪酬模块后期实施主要负责人；     	__label__1
不论是简单的员工联络表，还是复杂的内部公_开信息库，人力资源在编制信息时，除了基本信息之外，还应该加入员工工作所在地、母语、第一外语和第二外语等信息。    	__label__1
参与人力共享系统实施，负责系统开发和运维管理工作。    	__label__1
支持PeopleSoft系统和SAP系统切换    	__label__1
参与实施，完成关键用户培训、SIT测试、UAT测试，支持系统上线；    	__label__1
全面融合的通信及协作应用大幅提升了企业办公效率    	__label__0
针对编辑模块编写测试用例,使用黑方法达到功能覆盖,提交、管理和汇总缺陷报告,写产品缺陷报告,编写测试总结    	__label__0
第三代和第二代有着本质的区别。    	__label__0
 将服务类产品推广到客户现场，并对所在区域各分公司的服务人员进行HR及系统部署方向与优化类项目的技术培训，提升项目的交付能力；    	__label__1
 根据项目规范建立项目组内部管理和沟通机制    	__label__0
人力资源管理必须借助信息化技术，打造新的管理模式，节省精力和时间用于更加重要的职能，进而直接改善企业的生态环境，推动组织的不断进步与发展。    	__label__1
负责eHR系统项目监理商的评估、选型    	__label__1
职责范围是构筑，实施及维护HR模块的系统。     	__label__0
工作描述：根据项目需求，完成计划的制定    	__label__0
了解并掌握客户人才需求信息    	__label__1
 支持所在区域各分公司的HR项目和系统部署项目，模块包括基础人事、薪酬、考勤、绩效模块。    	__label__1
发挥系统、互联网及移动端的互联互通优势，使O2O企业人员组织、管理相对松散的缺点被压缩到极小，形成更紧密、可控的虚拟组织与实体组织相结合的HRIS架构。     	__label__1
eHR与HRIS、HRMS    	__label__1
 系统开发功能设计    	__label__0
集团HR系统涵盖组织、人事、保险、考勤、薪酬、培训及部分个性化模块等内容    	__label__1
员工结构统计分析，依据年龄、学历、职级等维度    	__label__1
沙钢集团EHR项目，包含组织人事、薪酬福利、时间管理、绩效管理、招聘培训等模块     	__label__1
编写技术设计文档，二次开发文档。     	__label__0
任职期间，主要担任项目经理和实施工程师工作，侧重对运维平台里巡检和排班功能进行技术支持及与铁道部车站方面的沟通协调工作。    	__label__0
提供人力成本等相关分析报告，结合生产数据、财务数据进行综合分析，为企业解决人力成本浪费提供数据支持。    	__label__1
作为HR顾问，负责ERPHR系统实施工作。     	__label__0
eHR厂商，洗牌在即，生还是死？出路何在？    	__label__1
 负责后台交易业务设计，运用axure进行产品原型设计，负责资产管理管理端、IM项目的跟进，产品测试，测试报告以及验收报告撰写与反馈    	__label__0
技术要求：    	__label__0
项目负责人    	__label__0
跟进硬件、软件、结构等开发进度，主导相关部门进行DFM评审    	__label__0
 新需求的分析设计工作    	__label__0
与市场部、产品部协调，制定产品开发、运营方案以及实施策略    	__label__0
项目管理：对项目干系人进行协调沟通，项目工作排期计划，项目资源协调分配，项目风险把控等；    	__label__0
协助功能顾问梳理需求，进行差异化分析；    	__label__0
推动项目薪酬模块上线；     	__label__1
人事组织的确定。薪资公式的编写。在公司的各项规章制度没有完善的情况下，结合自己对于各个客户的了解和经验，给与各方面的建议和支持，并力促系统的推广使用。     	__label__1
与业务部门及研发同事沟通开发进展和进度跟踪；    	__label__0
海航集团PeopleSoft人力资源系统培训及绩效模块，HRBI数据分析系统的建立和推广工作；     	__label__1
完成集团总部及东莞区域的HRIS建设，包含硬件安装调试（服务器、考勤机、门禁机、身份证阅读机等）及软件功能实现（人事管理、考勤管理、薪酬管理）。    	__label__1
负责诊断之前系统实施连续失败的原因，重新搭建人事系统架构，梳理整合非集团化管控模式下的人事各项业务，并通过信息化手段建立多级管控体制，同时切实减少人事业务量达到降本减员目的。    	__label__1
市场的激烈厮杀让这个市场逐渐明白，eHR，就像是梦中的美妙女神，让人心旷神怡的期待，却始终难以靠近，更加难以博取芳心。    	__label__1
项目名称：通达信网站设计    	__label__0
此项目为自开发项目 此项目融资500万,累计投入超过400万,研发周期为半年,参与人员累计超过40人,产品已投入市场并持续运营中,预计18年将盈利    	__label__0
参与实施，完成数据收集、整理，SIT测试、UAT测试，支持系统上线；    	__label__1
 参与业务流程设计、系统配置、项目文档编写、用户培训、数据准备、上线支持及其它技术服务。    	__label__0
为德资企业大众汽车金融进行白金HRM产品的实施。制作各类水晶报告（劳动合同、试用期评估、合同续签等）     	__label__1
与客户进行需求分析，全程参与绩效打分过程，及时处理相关技术问题，根据需求对评核结果进行分析处理。     	__label__0
在佳通集团范围内使用Peoplesoft系统全面替换原有奇正系统，项目范围涵盖使用原系统的所有单位及人员，使用Peoplesoft系统的组织及岗位管理、人事、薪酬、自助服务、工作流管理等功能模块。     	__label__1
设计人力资源相关模块的系统原型，编写设计文档    	__label__1
负责eHR系统项目监理商的选型，与多家备选监理商沟通，了解各家优势，评估每家的综合实力，为竞争性谈判（招投标）工作做准备；    	__label__1
 eHR系统软件供应商接洽，观看其产品演示，分析文档和报价，比较各家产品的优劣性。特别是深入分析Oracle Peoplesoft产品以及其云端产品，结合公司自身需求，提炼最优解决方案，为eHR系统选型决策提供重要理论支持和量化数据参考。    	__label__1
项目名称：四川惠宜康科技有限公司    	__label__0
 Kronos系统功能配置；    	__label__1
 对美的HRBI系统人力资本管理模块内容臃肿，路径不清晰和使用困难等缺点，对本模块提出优化和升级建议，并针对以后的系统扩展性提供框架的合理化建议；    	__label__1
负责HR新系统实施；    	__label__1
实施范围大：对绩效系统产品架构、产品功能模块完成重构，覆盖原绩效系统全功能范围，并且对已有问题进行修复与升级；    	__label__1
任职公司：成都嘉讯软件有限公司    	__label__0
提交各项设计成果进行评审，并及时将评审中发现的问题安排整改，负责评审报告的发布    	__label__0
截至2018年2月，共进行了三期建设，网址为www.rainbowbenefits.com。为整个公司弹性福利方案的落地提供信息化平台保障。同时平台建设为SaaS模式，支持供应商和其他企业的入驻。     	__label__1
根据需求，约谈各系统供应商，进行前期选型工作，对比各家产品的优略性；    	__label__0
产品（人力资源信息系统管理）工作：    	__label__1
发展出基于互联网模式实现的新式HRIS体系，更加快捷与高效的支撑新型O2O企业对于HRIS体系的新需求，将分布于全国范围内广阔区域的人员纳入到体系管控中来。    	__label__1
针对客户需求有针对性寻访候选人    	__label__1
项目负责人,主要职责:主要负责“人力资源系统”流程优化改造及深度推广工作    	__label__1
CAE 数据收集软件  1书写测试用例,执行测试,提交缺陷报告,提交测试报告    	__label__0
参与一线员工薪酬数据的分析；    	__label__1
辅助制定系统代码规范；辅助进行测试案例的编写。     	__label__0
二、学员课程评价高    	__label__0
HRBP系统访问量提升，极大提高HRBP的系统使用率和工作效率。     	__label__1
一、各方资源沟通协调    	__label__0
系统流程的优化     	__label__0
主导集团人事档案电子化工作：将传统的纸质档案转换为更易保存更易查询的电子档案，将人力资源工作逐渐从线下过渡到线上；    	__label__1
 撰写需求分析报告，取数逻辑说明等相关文档，建立业务需求与技术实现中的沟通渠道；    	__label__0
将自己在传统企业和互联网公司规划、搭建、运维HRIS体系平台的丰富经验，移植到互联网金融公司中。使用Oracle HCM体系中的Fusion系统，构建起维信金科的eHR管理平台。    	__label__1
根据职能类型实现各组件功能控制    	__label__1
大厂商尚且难以胜利，小厂商生存维艰。    	__label__1
人工共享系统运维，支持业务运营，解决系统问题，开发新增需求；    	__label__1
实现了闸机，移动端等多渠道的考勤数据收集；系统自动处理的全公司加班情况分析报表；公益假，家长会假等特色福利假期的全线上处理等功能     	__label__1
工作业绩：eHR、招聘系统、人力资源数据平台上线运营，将考勤、薪酬、绩效、档案管理、招聘全流程线上化。    	__label__1
负责唯品会人事主系统人事模块&薪酬模块，考勤系统，员工门户，HRBP门户的HRIS产品设计全流程工作；任职期间实现SSC全流程和COE部分流程的线上化；集团内各子公司人事数据拆分管理和共享；HRBP页面去ERP化和产品化；员工PC端和手机端门户的搭建等信息系统建设成果。     	__label__1
(结合人力资源信息系统，将外部收集的行业数据进行融合、分析，向集团领导提供决策所需数据信息。    	__label__1
负责ERP系统相关项目的管理工作，包括需求分析、用户沟通、项目推进、项目质量监控、人员管理、相关文档编写、项目验收等相关工作。    	__label__1
高管通讯录功能，集成报备事项&出差信息    	__label__1
通过与对方公司国内、国外各团队协作，确保了有效迁移，不影响日常使用。     	__label__0
中国邮政人力资源系统 该项目为中国邮政人力资源系统一期,主要涉及的模块包括:组织机构管理、人员信息管理、人员变动管理、网络报表、数据报表分析    	__label__1
负责的公司办公系统已申请专利，且已有意向购买人员。     	__label__1
其他工作支持。    	__label__0
这就是为什么竞争如此激烈的原因所在：产品过于简单，彼此也没有太大的比较优势，也就是现在eHR产品生死存亡的命门。    	__label__1
人力资源数据分析系统成功上线,实现了人力资源数据的可视化、标准化、体系化,通过数据挖掘、对标分析,锚定公司人才结构,为后期人才优化指明了方向,同时帮助公司梳理了业务流程,为人力资源应用系统的开发奠定了基础    	__label__1
协助客户和项目组完成项目验收并提交相关报告    	__label__0
经过第一二代产品的发展，系统当中已经存储了海量数据。    	__label__0
职责：负责公司eHR系统的系统规划、行业和市场分析、产品设计、功能定义等工作；负责需求的跟踪与控制；管理和协助项目的开发、落地，达成产品目标；    	__label__1
一些仅仅能够录入一些人事信息的小软件也号称eHR。    	__label__1
在平台的搭建阶段，全面负责团队的日常管理，以PMP的管理原则贯穿项目始终，有效的控制着项目的整体范围、时间进度、费用成本、项目质量等，积极应对项目实施过程中的沟通问题、项目风险，以及团队人员调整给项目所带来的挑战，最终成功的完成了系统的上线与推广工作，为HR部门的整体绩效提升做出了贡献。    	__label__1
云通信作为企业办公入口， 将企业邮箱、即时通信、电话会议、网络会议、视频会议、企业网盘等在内的多种通信协作功能融合至同一终端，用户几乎在一个界面就可方便使用    	__label__0
需求评估：对新增开发需求进行实施评估；     	__label__0
腾讯风铃 产品经理 跟腾讯广告媒体事业部合作,在江苏省区域全面代理腾讯风铃建站产品,并跟风铃开发团队联合设计开发风铃的行业拓展组件模块    	__label__0
担任项目经理，同时担任薪酬模块模块负责人；    	__label__0
在第二代末期，能够率先在第三代产品上有所突破，才能够甩开其他竞争对手，形成高大结实的壁垒，抵挡竞争。    	__label__0
微信招聘公众号的开通、搭建、测试、推广、上线工作，为公司开拓新媒体招聘渠道，提高简历获取量，同时也借助微信平台进行企业形象的展示和宣传工作；    	__label__1
在移动互联网与大数据时代，勇于创新，提出微信培训（微课堂）的理念，替代传统的eLearning模式，利用员工碎片化的时间进行在线学习培训。引入微信企业号这种新媒体工具，通过员工身份认证、信息定向推送、行业资讯展示等内容，满足公司员工提供多元化和个性化的培训需求。    	__label__1
 针对实际业务需求，设计Kronos系统实施方案，并考虑和其他人力资源系统的数据对接实现；    	__label__1
Heidenhain海德汉项目薪资部分验收时，客户特别向公司提出对本人的褒奖和肯定，并强烈要求公司在后续部分继续由本人为该公司提供服务。    	__label__1
“eHR”的“e”体现在以下三个方面：    	__label__1
为远洋地产打造的一套适合自身发展的信息化流程管理平台 本次项目205万,涉及到用友HR业务的绩效管理模块( 销售总监&项目总监    	__label__1
编写技术设计文档。    	__label__0
项目推进：推进项目进度、风险管理等，配合实施商进行业务调研、蓝图设计、集成测试&UAT测试、上线培训等工作    	__label__0
外包人员管理方案制定和方案实施；    	__label__0
 负责产品市场推广活动的演讲支持，并积极配合市场推广相关活动；    	__label__0
国际化    	__label__0
提交测试日报、周报,反馈测试结果,书写测试总结报告    	__label__0
HR SSC（人力资源共享服务中心）工作：    	__label__1
否则，可能真应了马云那句话，死在美好到来的前夜。    	__label__0
对人力资源信息系统项目进行统筹、规划，全面负责项目管理，包括需求调研、项目进度管理、风险管理、功能开发、测试、系统实施等。    	__label__1
熟悉以下技术Dreamweaver\photoshop\VIsio\Axur等软件工具    	__label__0
 根据海航集团实际业务需求，规划其人力资源数据分析系统的整体框架结构并提出合理化建议；    	__label__1
负责期间，顺利完成项目运维工作；    	__label__0
 相关用户的培训     	__label__0
但是这一代产品也就是在这个地方遇到了前所未有的挑战。    	__label__0
经过第一、二代的洗礼，有一定能力的厂商会存活下来。    	__label__0
产品功能设计及计划管理    	__label__0
如上分析，HRIS与HRMS的关系已经清楚：而ASP只是人力资源管理信息系统利用的形式之一，是eHR的表现形式之一。    	__label__1
 用户操作手册的制定与编写    	__label__0
全面掌握全集团范围内人力资源部门的业务现状及诉求，并设计出有效的优化方案，以便通过Peoplesoft项目得以将这些优化方案落地。    	__label__1
利用项目经验，为客户的人事薪资制度提供建议，辅助客户梳理相关制度。特别是针对客户的需求，结合自身实践，给出关于假期扣款和年假政策的建设性意见，得到客户负责人的认可和采纳。     	__label__1
人力资源,招聘,人才,雇佣,面试,渠道,人才中介,校园招聘,薪酬,简历,人才市场,网络招聘,在电子商务模式日趋成熟化的今天，陈旧的工作模式和传统的工作手段造成HR主管们的主要精力耗费在了行政琐事上，除了采用这类国内知名的猎头公司来分担部分人资压力之外，似乎没有什么更有效的传统的方式。    	__label__1
测试：对各个功能进行测试（展示效果、私信功能、自动回复等），根据结果调整后台设置，对微信平台不断做出优化。     	__label__0
组建了低成本、高质量的项目团队    	__label__0
 整理需求分析    	__label__0
鼎胜铝业镇江公司的HR系统实施，包含组织人事、薪酬福利以及考勤管理     	__label__1
指定一到两种主要语言为“官方语言”，规定重要文件必须使用“官方语言”。    	__label__0
准备:调研可行性和需求进行调研后,有可实施改进空间    	__label__0
 系统问题的咨询和分析    	__label__0
截至2017年初,限时抢购频道已完成近1000W/月的GMV,UV约12W/天,转化率近3%    	__label__0
担任项目的实施顾问,主要负责该项目的各模块的前期调研工作    	__label__0
成功实现罗田分公司HRIS上线（含科讯及科柏高）、全集团HRIS数据同步及共享、宿舍信息化管理、餐厅消费与HRIS数据共享（含消费机的安装调试）、加班与门禁（三棍闸）的结合。     	__label__1
负责收集、梳理人力资源各模块需求，并给出优化设计建议及解决方案     	__label__1
整理数据字典；    	__label__0
招聘。    	__label__1
负责多项目的组织、管理，以及技术运维团队的日常运作    	__label__0
负责eHR系统项目竞争性谈判文件（招标书）的制作    	__label__1
负责项目全流程管理，包括需求调研、进度管理、风险管理、功能开发、测试、实施等，确保系统按期保质上线，负责系统迭代优化。    	__label__1
外包人员的考勤管理线上透明化，为后期全流程线上管理奠定了基础     	__label__1
售前支持：    	__label__0
针对Peoplesoft系统针对非专业用户界面不友好的痛点，设计开发面向HRBP的一站式工作台，提供各项数据的操作修改功能，人员信息查询和导出功能和特定时间推送的负责部门数据分析类报表。     	__label__1
跟进开发进度，主导相关部门进行DFM评审    	__label__0
根据业务需求分析系统优化点，绘制业务流程图和设计产品原型；    	__label__0
对美的集团人力资源部HRBI系统，人力资本分析和内部劳动力市场模块进行整合和优化工作，同时对美的集团数据平台和HRBI系统进行平台整合，以便支持美的集团、事业部层面对人力资源数据进行综合分析和统一管理的需要；    	__label__1
制定项目阶段性目标和项目总体控制计划    	__label__0
作为项目产品负责人，进一步明确项目范围、成本、计划、进度和定义等目标，协调公司相关部门和外部资源，推动产品外观设计、结构设计、电子设计、UI、包装等设计、试产和量产，提前半个月实现量产目标    	__label__0
 部分系统功能配置工作；     	__label__0
现有HR系统的维护和创新性优化     	__label__1
同时，工作流的实施，实现了集团总部对分公司人事事务的实时把控，部分重要职位的招聘、入职、异动等事务最终审核权归集团人事部所有    	__label__1
负责Peoplesoft HCM系统在全集团范围内的推广及有效应用与持续优化。    	__label__1
配合项目项目经理进行项目调研,确定企业对ERP的需求,并分析企业管理现状与所实施的ERP系统的差距,拟定企业流程重组和管理改进方案    	__label__0
团队管理：负责团队日常运营管理，团队成员招聘、培训及绩效考核等工作。    	__label__1
eHR助力中国企业国际化    	__label__1
明确客户的需求，详细了解礼来的“小猪计划”，和研发部门做好沟通，完成最后的实施，其中包括安装、培训、调试等工作。     	__label__0
它必须包括一些核心的人力资源管理业务功能，比如招聘、薪酬管理、培训（或者说在线学习）、绩效管理等    	__label__1
针对项目特点，给出自己的实施计划建议方案，并向领导提前提出项目可能存在的风险点。     	__label__0
作为SAPHR顾问，负责福建省电力公司和新疆电力公司ERPHR模块系统实施。     	__label__1
苏州移动APP工厂 产品经理 联合苏州移动共同设计开发APP工厂平台,主要面向苏州范围内的中小企业,提供模块化APP建设服务    	__label__0
部门新人培训     	__label__0
实现深圳机场集团年度绩效评核的系统化、信息化。     	__label__1
严格贯彻各类规范    	__label__0
负责部分子公司的薪资核算，人力成本预算与核算；    	__label__1
主要负责招聘、人员薪酬及KPI的制定    	__label__1
海鸥II项目包括了52个服务包,涉及到了远洋地产主线类、服务类、监控类各项业务流程,利用先进的管理思想和国际化企业的管理标准, 项目总监    	__label__0
负责eHR系统项目软件供应商的评估、选型；    	__label__1
整理目前纸质人事档案管理存在的问题；    	__label__1
 此项目优化改造累计投入100万,项目工期为半年,参与人员累计超过10人    	__label__0
搭建集团人事档案电子化体系，将员工简历、入职材料、各类表格表单等纸质文档转换为电子文档，并建设文档管理系统（MDS）使其能够被快速查阅调用。同时，借助电子化工作机会，对既有的纸质档案进行了一次完整梳理，了解目前现状、整理存在问题，并据此制定档案管理的规则规范，使集团的人力资源工作更加科学化、标准化、高效化。    	__label__1
结合公司实际和个人专长，使用EHR、OA办公系统时提出流程及操作优化需求、完善后自测；向相关部门提供合理、专业的数据输出报告等；    	__label__1
三、项目运营:kick off 讲师协调 反馈收集 效果评估    	__label__0
不管采用BI还是其他模式，重要的是能够支持人们进行决策。    	__label__0
业绩：在职期间带领团队实施了LG集团多个EHR项目，获得业务方的好评    	__label__1
email、视频会议、电话会议、Webinar等技术手段，能够帮助人力资源对全球的员工进行统一的、标准化的信息传递、政策传达和培训。    	__label__1
项目功能实施    	__label__0
团队管理：负责团队日常运营管理，团队成员招聘、培训及绩效考核等工作。    	__label__0
控制版本迭代节奏    	__label__0
国网预规项目实施（2015年9月至2016年3月）     	__label__0
校园招聘 广州区校园招聘前期宣传 宣讲会 面试    	__label__1
实施范围：组织人事、时间管理、薪酬管理     	__label__1
可惜一些厂商这一步也做不好，其报表功能总是被诟病。    	__label__0
然而，从本土企业转变成跨国企业，是一个充满矛盾和“疼痛”的过程。    	__label__0
系统规划：根据公司战略发展需要，进行人力资源相关系统规划设计，包括eHR、招聘系统、人力资源数据平台、elearning等。积极推动企业内部信息化融合，使各业务系统（包括SAP、CRM、财务系统等）与人力资源系统实现互联互通。    	__label__1
任职期间，主要担任技术支持和实施负责人工作，负责对现场问题深度技术支持及与铁道部车站方面的沟通协调工作。    	__label__0
由于现场实施期间的表现，客户决定向其子公司阿法拉伐（昆山）新购买和推广使用公司的产品，并点名提出让本人提供全称实施服务     	__label__1
担任项目组织人事流程、接口实施主要负责人，同时担任薪酬模块方案顾问；     	__label__1
1/输出《房产销售人员奖励方案》/《移民销售提成方案》/《人力资源手册》/《招聘奖励方案》等    	__label__1
2017年霞浦核电站ERP实施项目 700万    	__label__0
蒙牛集团全国顺利推广及上线，系统稳定使用；    	__label__0
实施模式创新：突破唯品会固有PS系统实施模式，采用前端+PS后台模式完成系统升级，极大增强用户体验     	__label__1
根据项目经理的需求使用DIV+CSS实现网页布局    	__label__0
既有eHR系统优化：对既有用友NC系统中人力资源模块使用中遇到的问题进行跟进，对新功能进行测试和优化；    	__label__1
 UAT测试及系统上线支持；    	__label__0
对小组成员进行业务背景培训,,制定测试计划,安排测试任务、测试进程,评定测试用例、进行测试项目控制    	__label__0
项目后期薪酬改革系统顺利过渡；     	__label__1
担任项目培训模块方案负责人，指导搭建培训模块整体方案；    	__label__0
参与商旅项目、IT Help Desk系统实施；    	__label__1
主要负责项目前期的投标、竞标、合同签订以及项目后期的需求调研、二次开发、系统实施、项目推广等项目管理工作    	__label__0
做中国最深入的猎头 成都精英达人力资源有限公司 加入天堃传媒,司职产品总监,负责纷享苏州项目(苏州游目的地品质在线服务品台,也是苏州新媒体联合会发起单位之一) 基本信息     	__label__1
通过系统的一些限制，提高上报数据的准确性，做到“数对人头、摸清家底”；     	__label__0
eHR产品，从其生命周期来看，至少存在三个时代。    	__label__1
控制项目现场的工时、变更、风险、培训。因系统核心用户设计全体员工，故客户对系统的安全性和数据的正确性极为重视，因此在现场做好客户的引导和沟通工作，以及帮忙指定测试计划和方案，是项目的最重要内容。     	__label__1
项目1基于无源智能锁的新能源检修管控云平台 该产品主要面向风力发电企业,为其提供两票(工作票、操作票)业务管控,并利用与无源智能锁的联动落地安全生产管控政策,为新能源企业提供一体化检修解决方案    	__label__0
项目描述：通达信网站的整合主要是完成账户一体化的设计，一站式登录所有相互信任的网站，减少重复的注册登陆，提升用户体验    	__label__0
负责项目全流程管理，包括需求调研、进度管理、风险管理、功能开发、测试、实施等。     	__label__0
系统将HR与已使用的生产管理和财务管理模块相结合。    	__label__1
欺骗一次，不会有第二次机会    	__label__0
组织试产后总结，推动问题改善和完成评审    	__label__0
主导微信培训平台的技术方案与架构；    	__label__0
集成移动办公    	__label__1
担任研发部门评审组组长职务，参与重要项目的设计、评审工作    	__label__0
有良好的沟通技巧和较强的协调能力;语言表达能力强，亲和力佳    	__label__0
项目管理    	__label__0
 项目过程文档的撰写，完成核心用户的使用和操作培训;    	__label__0
集团六家试点单位提前1个月完成上线工作、项目整体进度提前、人天成本下降；    	__label__0
参与并完成所负责的IT项目实施工作，管理项目过程，保障项目完成质量    	__label__0
负责需求分析,制定测试计划、测试策略    	__label__0
参与系统实施，负责 PeopleSoft 系统开发和上线支持工作。     	__label__1
人力资源部内部培训资料共享平台的搭建，提高总分公司、项目部间培训资料和文档的共享性和实时性；    	__label__1
跟踪并严格执行计划，控制项目进度    	__label__0
负责eHR系统项目竞争性谈判文件（招标书）的制作。    	__label__1
工作描述：负责公司软件开发项目解决方案的撰写，如长城证券理财app项目，渤海证券港股通，中银证券金融商城和网上营业厅，中山证券Mac版网上交易客户端等    	__label__0
处理公司eHR项目的全部工作    	__label__1
负责全人力资源业务的信息化工作；前期参与工资改革、绩效制度建立、职业发展通道建设等项目并负责信息化实现。     	__label__1
工作描述：负责公司互联网医疗信息化平台的搭建、维护、迭代    	__label__0
如果发现项目实 际进展显著偏离计划，则及时采取纠正措施    	__label__0
网心科技(迅雷路由器 2013年度投资千万资金由资深技术VP带队打造的一个“网心科技公司路由器”项目    	__label__0
作为HR顾问，负责ERPHR系统实施工作     	__label__1
作为部门接口人，负责部门所有对外活动、会议、团建、外包人员入职等事宜。    	__label__0
建立员工信息库。    	__label__1
和需求方进行需求分析和产品定义，输出PRD方案文档    	__label__0
 项目管理，协调开发、测试资源及相关部门、推进解决项目周期中的问题,在保证质量的情况下推进项目及版本落地    	__label__0
提前上线：实际上线时间，较原计划上线时间提前1个月；     	__label__0
按照测试案例进行系统测试、试运行工作，收集汇总问题进行反馈，为系统BUG的修改和系统优化提出建议。    	__label__0
集团HR系统分布式部署，海澜特有的条线管理模式，给组织架构的设计与搭建造成极大困扰。    	__label__1
咨询顾问&项目经理,主要职责:针对中国电信人力资源业务进行流程梳理,制定适合中国电信人力资源信息化建设的方案    	__label__1
期间经历蒙牛集团组织架构调整与薪酬制度改革导致的系统优化工作；     	__label__1
负责系统接口、审批流程梳理以及设计工作；     	__label__0
扎实的技术功底    	__label__0
完成系统功能开发工作，包括页面、报表、工作流、接口；    	__label__0
 用户操作手册的撰写和最终用户的培训工作；     	__label__0
实现北京电力公司ERPHR系统成功上线，其中HR模块上线子模块有：组织管理、人事管理、考勤管理、薪酬管理、教育培训管理、离退休管理、党团管理、MSS和ESS，实现了SAPHR与人资管控系统接口功能。模块覆盖范围有市公司、下属子公司、相关直属单位和代管单位。实现了人员的全口径覆盖。     	__label__1
负责eHR系统项目软件供应商的评估、选型    	__label__1
基于互联网的人力资源管理流程化与自动化。    	__label__1
人力资源管理领域最知名也是最大的几个咨询公司，比如 HayGroup、WatsonWyatt、Hewitt、Towers Perrin、Mercer等都将信息技术进入人力资源管理后的时代称之为“eHR”时代，他们相继推出了“eHR”服务。    	__label__1
负责ERP系统运行维护管理工作。     	__label__1
组织招标，选定合格的服务供应商；    	__label__0
进一步讲，HRIS、HRMS与eHR有什么关系？表面看来，好像HRMS之后的阶段是eHR    	__label__1
具体负责公司eHR系统项目的工作；    	__label__1
 撰写需求分析报告，取数逻辑说明等相关文档，建立业务需求与技术实现中的沟通渠道；    	__label__0
简易招聘系统“招聘宝”的开通与初始化工作，提高公司招聘效率，减轻招聘专员简历筛选的工作量；    	__label__1
需求评估：对新增开发需求进行实施评估；    	__label__0
系统上线后，将HR处理每月薪资的时间由1周缩短至3天以内。    	__label__1
eclipse、开发中间件(开发工具) SUN/IBM/MAS/EMA服务器(硬件环境) Windows、Linux、CenterOS、Tomcat0、WebLogic、Oracle9i、DBSyBase、MySQL(软件环境)广西电信OA系统Mkey适配项目 安徽电信Mkey适配项目 山西上高政府Mkey适配项目 中国电信（移动）OA0系统 MAS2移动代理服务器 中国电信（移动）OA0系统 四川天齐射洪锂业ERP管理系统    	__label__0
成立了一支业务熟悉的人事实施队伍，对人事部门最终用户进行了为期两周的培训，与相关责任人建立了良好的关系，完成了系统上线的方案    	__label__1
负责hris整体规划及具体实施。     	__label__1
负责社保、薪酬业务项目的推进，根据员工实际的入职、转用工、调动、离职等业务场景以及地方政策的个性化等梳理业务场景，协调人员关系，解决问题并组织培训地区人员，推进全网落地执行；    	__label__1
跟踪候选人保质期内在客户方工作情况,做好协调,确保其顺利度过与客户的磨合期    	__label__1
负责SAP系统的人员基础数据需求管理工作；    	__label__1
在一开始，关于人力资源管理软件，人们称之为“HRIS”（Human Resource Information System），这一阶段的软件，着重于对人力资源信息的采集、维护等功能，主要表现在软件中的模块大多是人事信息管理模块、考勤模块、薪资计算模块、福利管理模块等    	__label__1
监控项目各个阶段等日常项目管理工作    	__label__0
提前上线：实际上线时间，较原计划上线时间提前1个月；    	__label__0
成功实现子公司的人事薪酬模块独立运行；总部对下属子公司数据进行监管和统计；同时实现集团内公司间兼职，异动的相关业务场景线上化处理。     	__label__1
（建立人力资源数据信息标准化、规范化准则，结合绩效考核及数据分析指标，建立人力资源数据分析模型。    	__label__1
跟踪协调候选人与客户面谈相关事宜    	__label__1
产品选型、实施商甄选、商务谈判推进    	__label__0
帮助后端调试人员进行调试    	__label__0
作为终端业务方与IT技术方的沟通桥梁、作为内部HR业务的建议者、作为eHR项目的管理者，贡献着自己的力量。    	__label__1
指导完成薪酬方案；     	__label__1
全面负责专家远程支持平台的产品设计工作,包括硬件选型测试、软件原型设计等    	__label__0
人力成本相关数据分析，包括人工成本利润率、企业人工成本占比等    	__label__1
广州地区校园招聘负责人    	__label__1
 逾期考勤数据的系统自动追溯并计入下月薪资；    	__label__1
构架沟通平台。    	__label__0
中国邮政人力资源信息系统建成后,实现了数据平台全面贯通、集中管理,保证数据的完整性、准确性、真实性和更新的及时性,实现自主灵活的各类统计分析,并面向管理层的信息展示与决策支持    	__label__1
担任薪资、假勤、自助模块实施主要负责人以及后期运维项目负责人；    	__label__1
为项目二期阶段整理客户新需求，并提供解决方案，最终配置系统得以实现     	__label__0
统一企业“官方语言”。    	__label__0
业绩：为公司设计并实施了多款HR产品，SSC业务办理系统、配送员工考勤系统、一线支援系统、一线入职信息采集系统    	__label__1
eHR，是新经济时代下人力资源管理的趋势，网络技术的成熟与运用是其基础，ERP、CRM、SCM以及ASP等概念的出现和具体实施是其存在和发展的大环境，而对于人力资本开发和增值的迫切性是其终极原因，原因在于人力资源是企业经营诸要素中的第一位的资源，技术和资金相对于人力资源已经退居于其次。    	__label__1
作为HR顾问，负责ERPHR系统实施。     	__label__1
 对关键用户进行系统操作培训，协助其完成测试    	__label__0
项目招标：组织并参与对供应商进行标书评估、供应商面试、定标等工作；    	__label__0
负责相关业务系统产品需求调研、产品规划、产品的设计、产品上线管理    	__label__0
架构设计、需求分析、提出及设计：协调IT开发、运维、UI等资源支撑，独立负责全国人员办公系统需求分析与提出、PRD文档编写；利用Axure、亿图等软件进行功能需求、流程、页面设计，绘制产品原型（人力资源六大板块包含流程、培训考试、人才库、汇总等；协作模块；公司邮箱、通讯录；个人薪资等信息自助查询；通知公告等）；    	__label__1
 负责客户层面市场资料的制作并及时调整优化，包括产品宣传资料、推广主题PPT、客户案例包装等市场推广工具；    	__label__0
 相关业务人员的培训     	__label__0
领导者桌面    	__label__0
 参与增值产品定价及销售策略制定    	__label__0
通过整合研发和工厂等资源，按时完成量产，且上市销售    	__label__0
项目名称：迪蒙智慧交通项目    	__label__0
不知情的人可能会非常吃惊，在eHR这顶帽子下，不同的产品之间天壤之别的差异。    	__label__1
协助完成项目各阶段环境搭建，负责后期服务器及数据库管理工作；    	__label__0
它的使用者，除了一般的HR从业者外，普通员工、经理及总裁都将与eHR的基础平台发生相应权限的互动关系。    	__label__1
完成集成Oracle EBS、Hyperion、网报等系统接口的设计和开发；    	__label__1
知识管理项目 针对人力资源服务进行产品化,就产品化内容进行标准化并上线系统,使得人力资源服务平台化,减少对单个个人的依赖,对于整个知识所有沉淀和集中    	__label__1
ERP系统运维护管理，包括FICO/MM/HR/PM/PS/ABAP/BW/BASIS等不同模块的运维管理工作；    	__label__1
选型：企业招聘公众号选择订阅号还是服务号提供选型建议；    	__label__0
所谓eHR，即电子人力资源管理，是基于先进的信息和互联网技术的全新人力资源管理模式，它可以达到降低成本、提高效率、改进员工服务模式的目的。    	__label__1
北京市邮政科研所    	__label__0
eHR的引入可减少企业人力资源行政的负荷，优化人力资源管理流程，改善人力资源管理部门的服务质量，提供决策支持，帮助企业实现战略性人力资源管理的转变。    	__label__1
 撰写配置文档及用户培训手册，培训关键用户对系统的理解和操作；     	__label__0
随着人力资源管理的逐渐深入和“人力资本管理”的提出，企业对人力资源管理系统的要求不仅局限于信息的采集、更新和维护，而是要进一步对这些数据进行挖掘，依靠各类模型和工具，提供优化的管理流程、智能的分析、战略的决策参考等，于是“HRMS”（Human Resource Management System）的称呼随之出现，软件中增加了许多全新的模块，比如培训模块、绩效管理模块、门户、招聘模块等。    	__label__1
集团变革管理处人资线参与人力资源有关的企业业务流程优化及推进线上系统管理：    	__label__1
基础业务梳理&设计系统功能调整；    	__label__0
项目描述：四川省森林公安局金盾网门户网站 中国南车集团数据汇聚管理平台 遂宁市森林公安局金盾网门户网站 南车眉山车辆有限公司质检管理平台 四川省林业科学院门户网站 四川省林木种苗数据采集统计与发布系统    	__label__0
 系统配置及系统解决方案设计    	__label__0
主导集团开发类板块人力资源业务流程分析,通过分析现有业务流程的基础上进行业务流程重组,满足“海鸥II”人依附于事的管理思想,从而推动企业管理变革    	__label__1
作为项目成员参与，负责相关系统的建设。     	__label__0
监控产品开发进度，参与测试及业务验收；     	__label__0
团队建设：    	__label__0
负责产品的开发质量和进度控制，保证按期保质完成开发任务    	__label__0
部门内部业务流程梳理    	__label__0
 理解并协助HR业务人员整理其考勤业务需求和规则；    	__label__1
产品商业拓展    	__label__0
与IT运维、企划、技术人员沟通，负责手机考勤自助查询项目需求撰写，页面呈现设计，完善后测试功能，最终实现手机考勤自助查询实时数据更新。    	__label__1
在移动互联网时代，勇于创新，提出微信培训的理念，替代传统的eLearning模式，利用员工碎片化的时间进行在线学习培训。引入微信企业号这种新媒体工具，通过员工身份认证、信息定向推送、行业资讯展示等内容，满足公司员工提供多元化和个性化的学习需求。     	__label__0
任项目经理，全面负责需求梳理、供应商选型、项目规划、资源调配等工作。     	__label__1
负责期间，与客户方IT合作完成系统用户集成开发工作；    	__label__0
但是，随着互联网的发展、电子商务理念与实践的发展，我们目前所说的“eHR”已经是一个赋予了崭新意义的概念，是一种包含了“电子商务”、“互联网”、“人力资源业务流程优化（BPR）”、“以客户为导向”、“全面人力资源管理”等核心思想在内的新型人力资源管理模式    	__label__1
项目管理：协调内部相关人员及外部供应商进行各系统需求调研与分析，主导各系统规划设计，制定项目计划，把控项目成本、质量、进度及风险，确保项目按期保质完成。    	__label__0
项目描述：迪蒙智慧停车系统（掌停车）：适用于全国各城市，通过高位视频监控车辆驶入驶离记录，全线上支付流程为车主带来无感停车的体验    	__label__0
协助功能顾问，完成需求分析、功能设计工作；    	__label__0
eHR厂商：出路何在    	__label__1
 修改及增加 HR模块系统配置    	__label__1
有丰富的项目管理及ecshop\ecmall系统分析、制作能力    	__label__0
职位需求分析、协助搭建团队架构、招聘引进高端人才、薪资谈判    	__label__1
利用多维度组织管理对人事、考勤、薪酬、奖金、绩效等分别设立不同的组织体系，各体系之间人员相互关联，解决了他们纠结已久的同一员工在不同业务模块中不同组织的业务难题，使得各模块的业务在系统中顺利运行。    	__label__1
对薪酬模块实施后期进行现场支持工作，解决实施后期系统上线关键问题；    	__label__1
安徽电信人力资源系统 服务人员:30000人,角色:&项目总监    	__label__1
这个时代的产品，是真正产生比较竞争优势的地方。    	__label__0
负责CATLHRIS系统建设和维护，参与系统选型工作。     	__label__1
 监控Kronos部分项目进度；    	__label__1
2使用SQL查询语句对录入的数据进行查询验证、保障数据库正确地对数据进行增、删、查、改、计算    	__label__0
确保项目目标实现    	__label__0
益海嘉里进行 SAP HR项目实施，包括 HR的组织管理、人事管理、时间管理、薪酬子模块的实施，以及相关的报表开发。     	__label__1
人事六大模块(规划、招聘培训、薪酬绩效、员工关系)其他工作。    	__label__1
上述这些看法具有片面性，他们并没有弄清楚四者之间的关系。    	__label__0
与客户IT、HR方共同完成系统接口规划工作，保障流程信息化、HR外部接口的顺利实施；    	__label__1
产品需求调研及需求分析    	__label__0
负责和公司IT部门、以及外部实施商的沟通协调     	__label__1
全网社保系统的上线推广，含数据初始化、培训和业务宣导。    	__label__1
监控产品开发进度，参与测试及业务验收；    	__label__0
2016年国核示范电站人力资源深化应用项目 89万    	__label__1
职责描述：完成需求收集、整理、方案设计、确认等工作，负责技术架构设计和开发    	__label__0
组建并管理着由跨单位、跨部门人员组成的项目团队。    	__label__1
广东方胜人力资源服务有限公司 猎头顾问 公司简介:广东方胜人力资源服务有限公司是北京外企人力资源服务有限公司(FESCO)在粤注册的全资子公司,成立于 2003 年,注册资金 1000 万元人民币,资产总值逾亿元    	__label__1
按角色权限实现功能控制    	__label__0
完成薪酬业务信息化，顺利完成手工算薪至系统算薪过渡，薪酬工作效率提高25%；    	__label__1
主要工作内容：    	__label__0
综合来讲，相对于HRIS和HRMS，eHR是一种综合解决方案。    	__label__1
2/在总部的大力支持与配合下,独立前往宁波调查并处理腐败贪污事宜,顺利清退涉案销售人员,并在内部官网中发布处罚决定宣示全国各分公司人员    	__label__0
牛皮总归会吹破的，客户迟早会醒悟的    	__label__0
风险评估    	__label__0
主导人力资源分析报告定期生成及推送    	__label__1
人事其他模块工作。    	__label__1
对混合式的设计思路进行实践摸索,负责整个平台的设计、开发跟进和上线后的售前支持管理    	__label__0
统筹将业务需求转化为系统建设需求；    	__label__0
不过，随着IT技术不断渗入企业领域，给人力资源工作质量的提升带来新契机。    	__label__1
供应商评估：对人力资源各大供应商进行评估，综合成本、服务、实力等因素进行供应商筛选。    	__label__1
高管通讯管理    	__label__1
结合自身专业知识和项目经验，对各备选eHR系统软件供应商做出综合评估，对部门最终用户进行访谈并整理初步需求，根据初步需求与各软件供应商进行初步对接；    	__label__1
系统上线后与之前传统工作模式相比，报表制作的时间压缩50%，准确性大幅提升，几乎达到100%；    	__label__0
 兼任组织人事模块的部分工作     	__label__1
银杰公司劳务派遣HR系统实施    	__label__1
为客户实施白金员工自助服务（ESS）模块，设计在线工资单。使员工可以通过ESS系统查询个人的薪资单，取代了传统纸质工资单的发放，为公司解决办公成本，同时提高工资单的保密性。     	__label__1
国网北京市电力公司ERPHR模块集中部署项目（2015年8月至2015年12月）    	__label__1
 协助Kronos时间管理模块项目资源调动;    	__label__1
 理解实际业务和时间管理部分的需求；    	__label__1
工作职责：    	__label__0
从人力资源管理电子商务的角度来讲，eHR既包括B2C（“Business to Consumer”，这里的“Consumer”是指“Employee”，于是演变成“B2E”，是指在企业人力资源管理与开发活动中，视各级员工为该活动的“客户”，通过双方的网上互动完成相关事务的处理或者说交易，员工类似“客户”一样从网上获得人力资源部门提供的“产品”和“服务”），还包括B2B（“Business to Business”，指企业人力资源业务从外部服务商，比如咨询公司、招聘网站、elearning服务商等在线“采购”各类人力资源管理服务），甚至还要包括B2G（“Business to Government”，即人力资源管理活动中的有关与政府劳动人事部门发生业务往来的事务处理，由原来的书面、人工往来，转移到网上处理，比如保险、劳动合同审查等）。    	__label__1
7 与开发人员及PM、产品经理,沟通软件系统中的某些问题,提出软件修改意见    	__label__0
数据分析：    	__label__0
 负责承担实施项目文档和实施工作。    	__label__0
相对于开展巡回培训课程来说，eLearning有成本低、渗透性好、普及性强等特点。    	__label__0
确认技术要求和文件，包括外观和包装方案    	__label__0
职责：负责LG集团全球ERP实施和推广工作，主要参与LG China和LG CNS 韩国HR模块项目实施；HRIS系统规划和建设，EHR等项目的实施；    	__label__1
推行“eLearning”。    	__label__0
其他人力资源事务性工作：招聘、入离职手续办理、部门间工作协助等。    	__label__1
负责人力资源共享服务中心（HRSSC）信息化建设工作；    	__label__1
工作职责：配合销售人员做好售前咨询与支持工作，进行项目需求调研，参与产品研发、测试，根据项目要求进行软硬件安装及调试，配合项目组完成整体项目交付工作。    	__label__0
参与接口的设计、开发和测试，编写技术设计文档；    	__label__1
协助项目管理专员完成项目质量控制    	__label__0
职责描述：完成需求沟通，方案设计和确认工作，协调前端和移动应用开发，完成版本升级，负责底层应用技术架构设计和开发    	__label__1
这里的下一代产品，并不是用SaaS或者Ajax就叫下一代。    	__label__0
根据现状分析发现问题，不断优化流程，利用VISO等办公软件构建流图。    	__label__0
第一代eHR产品是信息仓库时代。    	__label__1
在这一代产品中，报表功能和人机界面是最为关键的核心比较优势，内置大量报表，比如国家有关部门、大型企业常用表单、报表的系统会收到青睐。    	__label__0
工作描述：规划所负责产品的需求规划和功能方向    	__label__0
网络技术的创造和发展对人类生活的影响与变革无处不在，并且逐渐延伸到人们思想的深处。    	__label__0
 主导金蝶技术类服务产品的开发，包括客户需求调研、规划、需求分析、开发指导、测试、客户现场验证等；促进专项服务产品的不断完善；    	__label__0
系统上线后，新苏集团每月从考勤周期结束到得出工资计算结果的周期从下月15号左右提前到下月5号之前，提高HR工作效率的同时，满足管理层需求。    	__label__1
因此，这一代的软件往往不会是单机版，而且BS架构的居多，实现分布式多终端实现业务管理。    	__label__0
二、主导并参与课程设计    	__label__0
微信培训平台的搭建：包括平台的立项、方案、申请、认证、测试、培训推广、初始化及上线，课程模板的制作与导入；    	__label__1
职位名称：金融产品经理    	__label__0
此文件的内容是我公司与候选人之间的面试总结    	__label__1
开发办公系统项目负责人：基于WEB端及互联网系统化思维，将公司100多万字的制度全部转化到系统操作节点中，省去文字制度的形式，实现整个办公系统从0到1的实现过程；    	__label__1
负责项目部的团队建设、人员管理。    	__label__0
 成绩： 2016年在云通信上消费的增值业务额度同比增长40% 2016年在云通信上下线业务为公司节省成本数十万元    	__label__0
更新需求开发功能说明文档    	__label__0
充分了解开发团队中每个成员的特长和优势，做好开发任务的分配，提交编码和测试阶段工作计划    	__label__0
这一代产品的幸运之处是市场开始形成气候，一些功能在线完成展现出了非常好的效益。    	__label__0
功能需求：    	__label__0
整合各分公司HR系统，实现数据及时同步共享。    	__label__1
通过白金软件系统对客户的人事管理、薪资处理、报告管理进行整合，使HR可以在一套系统中完成此前需要在传统纸质文档和EXCEL中进行的繁琐处理模式。     	__label__1
也有些人认为人力资源管理信息化的发展历程是按照HRIS、HRMS、eHR、ASP的方向发展。    	__label__1
可根据需要调配组内人员等资源    	__label__0
这种做法可减少异地招聘的成本，也可帮助总公司了解各子公司的招聘情况，同时还能建立起企业自己的人才资源库。    	__label__1
在信息技术部和人力资源部之间进行需求对接，提高双方的沟通效率；    	__label__1
对存在不同的字段内容给出自己的意见批注，待与部门领导讨论批准后进行各系统的统一化、标准化工作；    	__label__0
理顺公司流程,制定管理制度    	__label__0
蒙牛集团顺利完成组织架构调整期；    	__label__1
将企业邮箱和即时消息数据，通过云通信归档系统把他们备份到低成本的存储硬件上，使之存于日常的备份窗口外，当需要时，可以即时获取所需数据并快速搜索    	__label__0
这些产品往往会号称“固化管理流程”“提升管理水平”的原因，就在这里。    	__label__0
